NO ./north.xpm
SO ./south.xpm
WE ./west.xpm
EA ./east.xpm

F 0,0,0
C 0,0,50

111111111
1E0000001
101111101
101000101
101011101
101000001
111111111
