NO ./north.xpm
SO ./south.xpm
WE ./west.xpm
EA ./east.xpm

F 0,0,0
C 0,0,0

   11111111111
   10000000001
11110010011011
1S00000001101
11110010011011
   10000000001
   11111111111
