NO ./maps/north.xpm
SO ./maps/south.xpm
WE ./maps/west.xpm
EA ./maps/east.xpm

F 0,0,0
C 0,0,0

01111
1N001
10101
10001
11111
