NO ./maps/north.xpm
SO ./maps/south.xpm
WE ./maps/west.xpm
EA ./maps/east.xpm

F 0,0,0
C 0,0,0

11111
1N001
10201
10001
11111
